Aurora	Illinois
Naperville	Illinois
Elgin	Illinois
Waukegan	Illinois
Cicero	Illinois
Arlington Heights	Illinois
Schaumburg	Illinois
Evanston	Illinois
Bolingbrook	Illinois
Palatine	Illinois
Skokie	Illinois
Des Plaines	Illinois
Orland Park	Illinois
Tinley Park	Illinois
Oak Lawn	Illinois
Berwyn	Illinois
Mount Prospect	Illinois
Wheaton	Illinois
Hoffman Estates	Illinois
Oak Park	Illinois
Downers Grove	Illinois
Elmhurst	Illinois
Glenview	Illinois
Lombard	Illinois
Buffalo Grove	Illinois
Bartlett	Illinois
Streamwood	Illinois
Carol Stream	Illinois
Romeoville	Illinois
Plainfield	Illinois
Hanover Park	Illinois
Carpentersville	Illinois
Wheeling	Illinois
Park Ridge	Illinois
Addison	Illinois
Calumet City	Illinois
Glendale Heights	Illinois
Northbrook	Illinois
Elk Grove Village	Illinois
Saint Charles	Illinois
Woodridge	Illinois
Gurnee	Illinois
Mundelein	Illinois
Oswego	Illinois
Algonquin	Illinois
Niles	Illinois
North Chicago	Illinois
Highland Park	Illinois
Chicago Heights	Illinois
Burbank	Illinois
Lansing	Illinois
Glen Ellyn	Illinois
Oak Forest	Illinois
Wilmette	Illinois
West Chicago	Illinois
Batavia	Illinois
Lockport	Illinois
Melrose Park	Illinois
Vernon Hills	Illinois
Elmwood Park	Illinois
Westmont	Illinois
Harvey	Illinois
New Lenox	Illinois
Homer Glen	Illinois
Maywood	Illinois
Rolling Meadows	Illinois
Zion	Illinois
Morton Grove	Illinois
Dolton	Illinois
Blue Island	Illinois
Roselle	Illinois
Lisle	Illinois
South Holland	Illinois
Bloomingdale	Illinois
South Elgin	Illinois
Park Forest	Illinois
Darien	Illinois
Villa Park	Illinois
Geneva	Illinois
Grayslake	Illinois
Crest Hill	Illinois
Libertyville	Illinois
Evergreen Park	Illinois
Lake Zurich	Illinois
Lake Forest	Illinois
Homewood	Illinois
Alsip	Illinois
Bellwood	Illinois
Matteson	Illinois
Brookfield	Illinois
Mokena	Illinois
Montgomery	Illinois
Bensenville	Illinois
Franklin Park	Illinois
Round Lake	Illinois
Cary	Illinois
Deerfield	Illinois
Frankfort	Illinois
Palos Hills	Illinois
Hinsdale	Illinois
North Aurora	Illinois
Westchester	Illinois
Country Club Hills	Illinois
Bridgeview	Illinois
Prospect Heights	Illinois
Lemont	Illinois
La Grange	Illinois
Midlothian	Illinois
Chicago Ridge	Illinois
Forest Park	Illinois
Hazel Crest	Illinois
Hickory Hills	Illinois
Wood Dale	Illinois
Richton Park	Illinois
Wauconda	Illinois
La Grange Park	Illinois
Riverdale	Illinois
Warrenville	Illinois
Western Springs	Illinois
Justice	Illinois
Palos Heights	Illinois
Lincolnwood	Illinois
Markham	Illinois
Winnetka	Illinois
Schiller Park	Illinois
River Forest	Illinois
Worth	Illinois
Lyons	Illinois
Barrington	Illinois
River Grove	Illinois
Steger	Illinois
Flossmoor	Illinois
Winfield	Illinois
Glenwood	Illinois
Riverside	Illinois
Lake Villa	Illinois
Glencoe	Illinois
Itasca	Illinois
Harwood Heights	Illinois
Clarendon Hills	Illinois
Crete	Illinois
Hillside	Illinois
Island Lake	Illinois
Long Grove	Illinois
Broadview	Illinois
Oak Brook	Illinois
Lincolnshire	Illinois
University Park	Illinois
Winthrop Harbor	Illinois
Posen	Illinois
Lake Bluff	Illinois
Willow Springs	Illinois
Robbins	Illinois
Highwood	Illinois
Berkeley	Illinois
Monee	Illinois
Olympia Fields	Illinois
Stone Park	Illinois
Fox River Grove	Illinois
Palos Park	Illinois
Hometown	Illinois
Wadsworth	Illinois
Kenilworth	Illinois
Wayne	Illinois
Thornton	Illinois
Willowbrook	Illinois
Bedford Park	Illinois
Golf	Illinois
Wilmington	Delaware
Claymont	Delaware
Hammond	Indiana
Gary	Indiana
Portage	Indiana
Merrillville	Indiana
Crown Point	Indiana
Schererville	Indiana
Hobart	Indiana
East Chicago	Indiana
Munster	Indiana
Highland	Indiana
Griffith	Indiana
Dyer	Indiana
Saint John	Indiana
Chesterton	Indiana
Cedar Lake	Indiana
Lake Station	Indiana
Whiting	Indiana
Beverly Shores	Indiana
Wheeler	Indiana
Cherry Hill	New Jersey
Trenton	New Jersey
Camden	New Jersey
Vineland	New Jersey
Sicklerville	New Jersey
Marlton	New Jersey
Mount Laurel	New Jersey
Clementon	New Jersey
Sewell	New Jersey
Williamstown	New Jersey
Blackwood	New Jersey
Willingboro	New Jersey
Medford	New Jersey
Voorhees	New Jersey
Riverside	New Jersey
Vincentown	New Jersey
Mount Holly	New Jersey
Merchantville	New Jersey
Moorestown	New Jersey
Browns Mills	New Jersey
Riverton	New Jersey
Pennsauken	New Jersey
Maple Shade	New Jersey
Swedesboro	New Jersey
Collingswood	New Jersey
Haddonfield	New Jersey
Hammonton	New Jersey
Mullica Hill	New Jersey
Glassboro	New Jersey
Berlin	New Jersey
Gloucester City	New Jersey
Elmer	New Jersey
Oaklyn	New Jersey
Atco	New Jersey
Lumberton	New Jersey
Penns Grove	New Jersey
Burlington	New Jersey
Bellmawr	New Jersey
Woodbury	New Jersey
Franklinville	New Jersey
Mantua	New Jersey
Audubon	New Jersey
Pitman	New Jersey
Columbus	New Jersey
Somerdale	New Jersey
Westville	New Jersey
Woodstown	New Jersey
Wenonah	New Jersey
Thorofare	New Jersey
Runnemede	New Jersey
Haddon Heights	New Jersey
Clayton	New Jersey
Palmyra	New Jersey
Paulsboro	New Jersey
Stratford	New Jersey
Allentown	New Jersey
Pemberton	New Jersey
Hainesport	New Jersey
Newfield	New Jersey
Mount Ephraim	New Jersey
West Berlin	New Jersey
Magnolia	New Jersey
Barrington	New Jersey
Gibbstown	New Jersey
Wrightstown	New Jersey
Florence	New Jersey
Crosswicks	New Jersey
Monroeville	New Jersey
Mickleton	New Jersey
Glendora	New Jersey
Bordentown	New Jersey
Waterford Works	New Jersey
Roebling	New Jersey
Titusville	New Jersey
Woodbury Heights	New Jersey
National Park	New Jersey
Beverly	New Jersey
Mount Royal	New Jersey
Lawnside	New Jersey
Gibbsboro	New Jersey
Clarksboro	New Jersey
Buena	New Jersey
Pedricktown	New Jersey
Elwood	New Jersey
Minotola	New Jersey
Landisville	New Jersey
Malaga	New Jersey
Jobstown	New Jersey
Cookstown	New Jersey
Chatsworth	New Jersey
Newtonville	New Jersey
Richland	New Jersey
Bridgeport	New Jersey
Juliustown	New Jersey
Philadelphia	Pennsylvania
Lansdale	Pennsylvania
Bensalem	Pennsylvania
Morrisville	Pennsylvania
Norristown	Pennsylvania
Warminster	Pennsylvania
Southampton	Pennsylvania
Chester	Pennsylvania
Havertown	Pennsylvania
Collegeville	Pennsylvania
Media	Pennsylvania
Upper Darby	Pennsylvania
Langhorne	Pennsylvania
Ambler	Pennsylvania
Newtown	Pennsylvania
Wayne	Pennsylvania
Glenside	Pennsylvania
Drexel Hill	Pennsylvania
Marcus Hook	Pennsylvania
Feasterville Trevose	Pennsylvania
North Wales	Pennsylvania
Lansdowne	Pennsylvania
Springfield	Pennsylvania
Malvern	Pennsylvania
King Of Prussia	Pennsylvania
Clifton Heights	Pennsylvania
Huntingdon Valley	Pennsylvania
Hatboro	Pennsylvania
Aston	Pennsylvania
Broomall	Pennsylvania
Warrington	Pennsylvania
Chalfont	Pennsylvania
Bristol	Pennsylvania
Blue Bell	Pennsylvania
Jenkintown	Pennsylvania
Willow Grove	Pennsylvania
Elkins Park	Pennsylvania
Newtown Square	Pennsylvania
Darby	Pennsylvania
Bryn Mawr	Pennsylvania
Abington	Pennsylvania
Glen Mills	Pennsylvania
Conshohocken	Pennsylvania
Levittown	Pennsylvania
Horsham	Pennsylvania
Brookhaven	Pennsylvania
Plymouth Meeting	Pennsylvania
Wynnewood	Pennsylvania
Montgomeryville	Pennsylvania
Fairless Hills	Pennsylvania
Glenolden	Pennsylvania
Berwyn	Pennsylvania
Ardmore	Pennsylvania
Wallingford	Pennsylvania
Ridley Park	Pennsylvania
Richboro	Pennsylvania
Lafayette Hill	Pennsylvania
Bala Cynwyd	Pennsylvania
Narberth	Pennsylvania
Croydon	Pennsylvania
Jamison	Pennsylvania
Swarthmore	Pennsylvania
Kulpsville	Pennsylvania
Sharon Hill	Pennsylvania
Folsom	Pennsylvania
Oreland	Pennsylvania
Paoli	Pennsylvania
Morton	Pennsylvania
Devon	Pennsylvania
Fort Washington	Pennsylvania
Cheltenham	Pennsylvania
Folcroft	Pennsylvania
Prospect Park	Pennsylvania
Dresher	Pennsylvania
Villanova	Pennsylvania
Norwood	Pennsylvania
Wyncote	Pennsylvania
Merion Station	Pennsylvania
Haverford	Pennsylvania
Furlong	Pennsylvania
Bridgeport	Pennsylvania
Washington Crossing	Pennsylvania
Flourtown	Pennsylvania
Spring House	Pennsylvania
Gladwyne	Pennsylvania
Woodlyn	Pennsylvania
Essington	Pennsylvania
Crum Lynne	Pennsylvania
Thornton	Pennsylvania
Holmes	Pennsylvania
Gwynedd Valley	Pennsylvania
Colmar	Pennsylvania
Bryn Athyn	Pennsylvania
Oaks	Pennsylvania
Worcester	Pennsylvania
Buckingham	Pennsylvania
Gwynedd	Pennsylvania
Valley Forge	Pennsylvania
Wycombe	Pennsylvania
Chester Heights	Pennsylvania
Eagleville	Pennsylvania
Dallas	Texas
Fort Worth	Texas
Arlington	Texas
Richardson	Texas
Plano	Texas
Garland	Texas
Irving	Texas
Grand Prairie	Texas
Mckinney	Texas
Frisco	Texas
Mesquite	Texas
Denton	Texas
Carrollton	Texas
Lewisville	Texas
Allen	Texas
Flower Mound	Texas
Mansfield	Texas
North Richland Hills	Texas
Rowlett	Texas
Euless	Texas
Grapevine	Texas
Desoto	Texas
Wylie	Texas
Little Elm	Texas
Bedford	Texas
Cedar Hill	Texas
Keller	Texas
Rockwall	Texas
Haltom City	Texas
The Colony	Texas
Coppell	Texas
Farmers Branch	Texas
Lancaster	Texas
Duncanville	Texas
Hurst	Texas
Southlake	Texas
Greenville	Texas
Midlothian	Texas
Colleyville	Texas
Sachse	Texas
Balch Springs	Texas
Forney	Texas
Benbrook	Texas
Prosper	Texas
Terrell	Texas
White Settlement	Texas
Seagoville	Texas
Addison	Texas
Anna	Texas
Fate	Texas
Glenn Heights	Texas
Red Oak	Texas
Royse City	Texas
Celina	Texas
Trophy Club	Texas
Princeton	Texas
Melissa	Texas
Roanoke	Texas
Lantana	Texas
Kennedale	Texas
Sanger	Texas
Richland Hills	Texas
Lake Dallas	Texas
River Oaks	Texas
Providence Village	Texas
Kaufman	Texas
Sunnyvale	Texas
Everman	Texas
Sansom Park	Texas
Hutchins	Texas
Krum	Texas
Oak Point	Texas
Wilmer	Texas
Pilot Point	Texas
Van Alstyne	Texas
Cockrell Hill	Texas
Argyle	Texas
Justin	Texas
Crandall	Texas
Aubrey	Texas
Lavon	Texas
Farmersville	Texas
Howe	Texas
Northlake	Texas
Double Oak	Texas
Edgecliff Village	Texas
Shady Shores	Texas
Ferris	Texas
Dalworthington Gardens	Texas
Ponder	Texas
Combine	Texas
Palmer	Texas
Leonard	Texas
West Tawakoni	Texas
Haslet	Texas
Krugerville	Texas
Bartonville	Texas
Josephine	Texas
Caddo Mills	Texas
Gunter	Texas
Quinlan	Texas
Oak Leaf	Texas
Copper Canyon	Texas
Nevada	Texas
Tioga	Texas
Lakewood Village	Texas
Blue Ridge	Texas
Celeste	Texas
Westminster	Texas
Elmo	Texas
Westover Hills	Texas
Weston	Texas
Copeville	Texas
Rosser	Texas